33 33 4
#################################
#....#..#......###......#..#....#
#.1.....#......###......#.....2.#
#....#..#......###......#..#....#
###.##..#......###......#..##.###
#.......#......###......#.......#
#..............###..............#
############...###...############
#..............###..............#
#..............###..............#
#...#########################...#
#...............................#
#...............................#
#...............................#
#...............................#
#...............................#
#...............................#
#...............................#
#...............................#
#...............................#
#...............................#
#...............................#
#...#########################...#
#..............###..............#
#..............###..............#
############...###...############
#..............###..............#
#.......#......###......#.......#
###.##..#......###......#..##.###
#....#..#......###......#..#....#
#.0.....#......###......#.....3.#
#....#..#......###......#..#....#
#################################
