30 22 4
........##############........
.............####.............
.............####.............
.............####.............
#............####............#
#............####............#
#............####............#
#..........2.####.3..........#
#............####............#
##############################
##############################
##############################
##############################
#............####............#
#..........1.####.0..........#
#............####............#
#............####............#
#............####............#
.............####.............
.............####.............
.............####.............
........##############........
