85 85 4
######......#############################################################......######
#...................................................................................#
#...................................................................................#
#...................................................................................#
#....................#.........................................#....................#
#....................#.........................................#....................#
#....................#.........................................#....................#
#....................#.........................................#....................#
#....................#.........................................#....................#
#.......#............#............#.......#.......#............#............#.......#
#........#.......................#........#........#.......................#........#
#.........#.....................#.........#.........#.....................#.........#
#..........#..#.............#..#..........#..........#..#.............#..#..........#
#...........##...............##...........#...........##...............##...........#
#...........#.................#...........#...........#.................#...........#
#..........#...................#..........#..........#...................#..........#
#..........#..............................#..............................#..........#
#..........#..............................#..............................#..........#
#.........#...............................#...............................#.........#
#.........#...............................................................#.........#
#.........#...............................................................#.........#
##########...........1...........#####.........#####...........0...........##########
#...................................................................................#
#...................................................................................#
#.........................................#.........................................#
#.........................................#.........................................#
#.........................................#.........................................#
#.........................................#.........................................#
#..........#...................#..........#..........#...................#..........#
#..........#...................#..........#...........#.................#...........#
#...........##...............##...........#...........##...............##...........#
#..........#..#.............#..#..........#..........#..#.............#..#..........#
#.........#.....................#.........#.........#.....................#.........#
#........#...........#...........#........#........#...........#...........#........#
#....................#....................#....................#....................#
#....................#.........................................#....................#
#....................#.........................................#....................#
#....................#.........................................#....................#
#....................#.........................................#....................#
#...................................................................................#
#...................................................................................#
#...................................................................................#
######....#########################...............#########################....######
#...................................................................................#
.....................................................................................
.....................................................................................
.....................#.........................................#.....................
.....................#.........................................#.....................
.....................#.........................................#.....................
.....................#.........................................#.....................
#....................#....................#....................#....................#
#.......#............#............#.......#.......#............#............#.......#
#........#.......................#........#........#.......................#........#
#.........#.....................#.........#.........#.....................#.........#
#..........#..#.............#..#..........#..........#..#.............#..#..........#
#...........##...............##...........#...........##...............##...........#
#...........#.................#...........#...........#.................#...........#
#..........#...................#..........#..........#...................#..........#
#.........................................#.........................................#
#...................................................................................#
#...................................................................................#
#...................................................................................#
#...................................................................................#
#...######...........2...........######.......######...........3...........######...#
#...................................................................................#
#...................................................................................#
#...................................................................................#
#...................................................................................#
#.........................................#.........................................#
#.........................................#.........................................#
#..........#...................#..........#..........#...................#..........#
#..........#...................#..........#...........#.................#...........#
............##...............##...........#...........##...............##............
...........#..#.............#..#..........#..........#..#.............#..#...........
..........#.....................#.........#.........#.....................#..........
.........#...........#...........###################...........#...........#.........
#....................#....................#....................#....................#
#....................#....................#....................#....................#
#....................#....................#....................#....................#
#....................#....................#....................#....................#
#....................#....................#....................#....................#
#.........................................#.........................................#
#.........................................#.........................................#
#.........................................#.........................................#
######......#############################################################......######
